/	mainapp.views.index	home:index
/<str:current_product_category>/	mainapp.views.index	home:category
/__debug__/render_panel/	debug_toolbar.views.render_panel	djdt:render_panel
/__debug__/sql_explain/	debug_toolbar.panels.sql.views.sql_explain	djdt:sql_explain
/__debug__/sql_profile/	debug_toolbar.panels.sql.views.sql_profile	djdt:sql_profile
/__debug__/sql_select/	debug_toolbar.panels.sql.views.sql_select	djdt:sql_select
/__debug__/template_source/	debug_toolbar.panels.templates.views.template_source	djdt:template_source
/admin/categories/create/	controllers.CreateViews.CategoryCreateView	admin:category_create
/admin/categories/delete/<int:pk>/	controllers.DeleteViews.CategoryDeleteView	admin:category_delete
/admin/categories/index/	controllers.ListViews.CategoryListView	admin:categories
/admin/categories/index/<int:page>/	controllers.ListViews.CategoryListView	admin:categories_page
/admin/categories/read/<int:pk>/	controllers.DetailViews.CategoryDetailView	admin:category_read
/admin/categories/update/<int:pk>/	controllers.UpdateViews.CategoryUpdateView	admin:category_update
/admin/order/restore/<int:pk>/	controllers.UpdateViews.OrderItemsUpdate	admin:order_restore
/admin/orders/list/	controllers.ListViews.OrderList	admin:orders
/admin/orders/list/<int:page>/	controllers.ListViews.OrderList	admin:orders_page
/admin/products/create/<int:pk>/	controllers.CreateViews.ProductCreateView	admin:product_create
/admin/products/delete/<int:pk>/	controllers.DeleteViews.ProductDeleteView	admin:product_delete
/admin/products/list/<int:pk>/	controllers.ListViews.ProductListView	admin:products
/admin/products/list/<int:pk>/<int:page>/	controllers.ListViews.ProductListView	admin:products_page
/admin/products/read/<int:pk>/	controllers.DetailViews.ProductDetailView	admin:product_read
/admin/products/update/<int:pk>/	controllers.UpdateViews.ProductUpdateView	admin:product_update
/admin/users/create/	controllers.CreateViews.UserCreateView	admin:user_create
/admin/users/delete/<int:pk>/	controllers.DeleteViews.UserDeleteView	admin:user_delete
/admin/users/index/	controllers.ListViews.UserListView	admin:users
/admin/users/index/<int:page>/	controllers.ListViews.UserListView	admin:users_page
/admin/users/read/<int:pk>/	controllers.DetailViews.UserDetailView	admin:user_read
/admin/users/update/<int:pk>/	controllers.UpdateViews.UserUpdateView	admin:user_update
/auth/	authapp.views.redirect_to_login	auth:index
/auth/edit/	authapp.views.edit	auth:edit
/auth/login/	authapp.views.login	auth:login
/auth/logout/	authapp.views.logout	auth:logout
/auth/register/	authapp.views.register	auth:register
/auth/verify/<str:email>/<str:activation_key>/	authapp.views.verify	auth:verify
/basket/	basketapp.views.basket	basket:view
/basket/change/<int:pk>/	basketapp.views.basket_change	basket:change
/basket/delete/<int:pk>/	basketapp.views.basket_delete	basket:delete
/complete/<backend>/	social_django.views.complete	social:complete
/contacts/	mainapp.views.contacts	contacts
/disconnect/<backend>/	social_django.views.disconnect	social:disconnect
/disconnect/<backend>/<association_id>/	social_django.views.disconnect	social:disconnect_individual
/login/<backend>/	social_django.views.auth	social:begin
/media/<path>	django.views.static.serve
/order/	controllers.ListViews.OrderList	order:orders_list
/order/create/	controllers.CreateViews.OrderItemsCreate	order:order_create
/order/delete/<int:pk>/	controllers.DeleteViews.OrderDelete	order:order_delete
/order/forming/complete/<int:pk>/	ordersapp.views.order_forming_complete	order:order_forming_complete
/order/product/<int:pk>/price/	ordersapp.views.get_product_price
/order/read/<int:pk>/	controllers.DetailViews.OrderRead	order:order_read
/order/update/<int:pk>/	controllers.UpdateViews.OrderItemsUpdate	order:order_update
/products/	mainapp.views.products	catalog:index
/products/<int:page>/	mainapp.views.products	catalog:index_page
/products/<str:current_product_category>/	mainapp.views.products	catalog:category
/products/<str:current_product_category>/<int:page>/	mainapp.views.products	catalog:category_page
/products/details/<int:product_id>/	mainapp.views.details	catalog:product
/products/details/<int:product_id>/<str:color>/	mainapp.views.details	catalog:color
